R    1200 1000

NO ./textures/bluestone.xpm
SO  ./textures/colorstone.xpm
WE   ./textures/greystone.xpm
EA    ./textures/wood.xpm


S ./path_to_the_sprite_texture
F 243,170,215
C 243,252,215

        1111111111111111111111111
        1000000000110000000100001
        1011000001110000000100S01
        1001000000000001000100001
111111111011000001110000000111111
1000000000110000011101111010111111
11110111111111011100000010001
11110111111111011101010010001
11000000110101011100000010001
10000000000000011000000101101
1000S000000000001101010010001
1100000111010101111101111000111
11110111 1110101 101111010001
11111111 1111111 111111111111    