R    1200 1000
NO ./textures/bluestone.xpm
SO  ./textures/colorstone.xpm
WE   ./textures/greystone.xpm
EA    ./textures/wood.xpm


S ./textures/barrel.xpm
F 243,170,215
C 243,252,215

        1111111111111111111111111
        1000000000110000000100001
        101100020111000020010001
        1001000000000001000100001
111111111011000001110000000111111
1000000000110000011101111010111111
111101111111110111000000100001
111101111111110111010100100001
11200000110101011100000010001
10000000000000011000000101101
1000N00000002000000010010001
110000111010101111101111000111
11110111 1110101 101111010001
11111111 1111111 111111111111    