R    1200 1000
NO ./textures/bluestone.xpm
SO  ./textures/colorstone.xpm
WE   ./textures/greystone.xpm
EA    ./textures/wood.xpm


S ./textures/barrel.xpm
F 243,170,215
C 243,252,215

        1111111111111111111111111
        1000002002110000000100001
        101100000111000000010001
        1201000000000001000100001
111111111211000001110000000111111
1000222222110020011101111010111111
111121111111110111000000100001
111121111111110111010100100001
11022000110101011100000010001
10002222200000011000000101101
1000220000020000000010010001
1100N0111010101111101111000111
11112111 1110101 101111010001
11111111 1111111 111111111111    