R    1200 1000 
NO ./textures/bluestone.xpm
SO  ./textures/colorstone.xpm
WE   ./textures/greystone.xpm
EA    ./textures/wood.xpm


S ./textures/pillar.xpm
F 255,255,255
C 255,255,255

           1111111111111111111111111
           1000000000110000000000001
           1011000001110000000000001
           1001000000000000000000001
111111111111000001110000000000001
100000000011000001110110111111111
11110111111111011100000010001
11110111111111011101010010001
11200200110101011100000010001
10002002000000000000000000001
10200020000000001101010000001
1100N00111010101111101111000111
11110111 1110101 101111010001
11111111 1111111 111111111111   